#	#	#	#	#	#	.	#	.	.	.
#	.	#	.	.	#	.	#	#	#	#
#	.	#	.	.	.	.	.	.	#	#
#	.	#	.	.	#	#	#	#	#	#
#	.	.	#	.	.	.	.	.	.	#
#	.	.	.	#	.	#	#	.	.	#
#	.	.	.	.	#	.	.	.	.	#
#	.	.	.	.	#	.	.	.	.	#
#	.	.	.	.	.	.	.	.	.	#
#	#	#	#	#	#	#	#	#	.	#